82,82,82,82,82,82,82,82,82,82,82,82,82,82,82,82,82,82,82,43,43,43,82,42,41,42,42,41,40,40,41,40,42,42,40,41,41,40,41,42,42,40,40,41,42,40,41,41,40,41
82,82,82,82,82,82,82,82,82,82,82,82,82,82,82,82,82,82,82,82,82,42,42,42,40,40,40,42,40,40,41,41,40,41,42,41,41,41,41,41,40,42,42,42,40,41,42,42,42,40
82,82,82,82,82,82,82,82,82,82,82,82,82,82,82,82,82,82,82,82,43,43,82,42,43,42,41,41,41,40,42,41,40,41,40,41,42,42,40,41,41,40,42,41,41,42,41,41,41,40
82,82,82,82,82,43,43,43,43,82,82,82,82,43,82,82,82,82,82,82,43,43,43,42,42,42,41,41,41,40,42,41,40,42,41,41,42,41,41,41,41,42,40,42,40,41,40,41,41,42
82,82,43,43,43,43,43,43,43,43,43,43,43,43,43,43,82,82,82,82,82,82,82,43,42,43,40,41,41,41,42,42,41,41,40,42,41,41,42,41,42,41,41,40,42,40,41,40,41,41
82,43,43,42,43,43,43,43,43,43,43,43,43,43,43,43,43,82,82,82,82,43,43,43,43,43,42,40,40,42,41,42,41,42,41,40,42,41,41,42,40,42,42,40,40,41,40,40,42,40
43,43,42,42,42,42,40,40,40,40,40,40,40,40,40,40,43,82,82,82,82,43,82,43,42,42,42,43,40,41,41,42,40,40,41,42,41,41,42,41,42,40,42,40,41,41,41,40,42,40
43,43,43,42,40,40,40,41,41,41,41,40,40,40,40,40,43,82,82,82,82,82,43,82,43,42,43,43,40,42,42,42,42,41,41,42,42,42,42,41,42,41,42,40,41,42,42,42,42,40
43,43,43,42,42,40,40,41,41,41,41,41,41,40,40,40,43,82,82,82,82,82,82,82,43,82,42,42,42,42,42,42,42,41,41,40,41,42,42,40,40,42,41,41,42,42,41,42,40,40
43,42,42,42,42,40,40,40,41,41,41,40,42,42,40,40,43,82,82,82,82,82,43,43,82,43,43,42,42,42,42,42,41,40,42,42,41,42,41,41,40,41,42,40,41,40,40,41,40,40
43,43,43,42,42,40,42,42,41,40,40,40,40,40,40,43,43,82,82,82,82,82,82,82,43,82,43,82,43,42,40,41,40,42,41,42,42,41,42,42,42,41,40,40,41,41,42,41,40,42
82,43,43,43,42,40,40,40,40,40,40,42,42,42,43,43,82,82,82,82,82,82,82,82,82,82,82,82,82,42,42,42,42,40,42,41,41,40,42,42,41,42,40,41,42,40,41,40,40,40
82,82,43,43,42,43,40,40,42,42,42,43,43,43,43,82,82,82,82,82,82,82,82,82,82,82,82,82,82,82,42,82,41,42,40,42,42,42,41,42,42,42,42,41,42,41,40,41,40,40
82,82,82,43,43,43,43,43,43,43,43,43,43,43,82,82,82,82,82,82,82,82,82,82,82,43,43,82,82,43,43,82,82,41,40,40,42,41,40,41,40,40,41,41,40,42,42,40,42,42
82,82,82,82,82,43,43,43,43,43,43,82,82,82,82,82,82,82,82,82,82,82,82,82,82,43,82,82,82,82,43,43,82,82,41,40,41,42,41,40,40,41,41,41,42,40,42,42,42,41
82,82,82,82,82,82,82,82,82,82,82,82,82,82,82,82,82,82,82,82,82,82,82,82,82,43,43,82,82,82,43,82,82,43,82,42,42,42,42,42,41,41,41,41,42,41,40,40,40,40
82,82,82,82,82,82,82,82,82,82,82,82,82,82,82,82,82,82,82,82,82,82,82,82,82,82,43,82,82,43,82,43,82,82,82,42,41,42,40,41,40,40,42,41,42,41,42,40,41,40
82,82,82,82,82,82,82,82,82,82,82,82,82,82,82,82,82,82,82,82,82,82,82,82,82,82,82,82,43,82,82,82,43,82,42,42,43,41,40,41,42,40,41,41,41,40,42,40,40,41
82,82,82,82,82,82,82,82,82,82,82,82,82,82,82,82,82,82,82,82,82,82,82,82,82,82,82,43,82,82,82,82,82,82,82,42,42,43,42,42,42,42,41,40,41,42,40,41,41,42
82,82,82,82,82,82,82,82,82,82,82,82,82,82,82,82,82,82,82,82,82,82,82,82,82,82,82,82,82,43,43,82,82,82,43,82,42,42,42,41,40,40,41,42,41,41,42,42,41,41
82,82,82,82,82,82,82,82,82,82,82,82,82,82,82,82,82,82,82,82,82,82,82,82,82,82,82,82,43,82,43,82,82,43,43,82,82,82,42,42,43,41,42,42,40,42,42,40,41,40
82,82,82,82,82,82,82,82,82,82,82,82,82,82,82,82,82,82,82,82,82,82,82,82,82,82,82,82,82,43,82,82,82,82,82,43,82,43,82,43,42,42,42,41,41,41,41,42,41,41
82,82,82,82,82,82,82,82,82,82,82,82,82,82,82,82,82,82,82,82,82,82,82,82,82,82,82,82,82,43,82,82,43,82,43,82,82,82,43,82,43,82,42,42,43,40,42,41,40,40
82,82,82,82,82,82,82,82,82,82,82,82,82,82,82,82,82,82,82,82,82,82,82,82,82,82,82,82,82,82,82,82,43,43,82,43,82,43,43,43,43,43,43,82,82,43,42,43,42,40
82,82,82,82,82,82,82,82,82,82,82,82,82,82,82,82,82,82,82,82,82,82,82,82,82,82,82,82,82,82,43,43,82,43,43,82,43,43,43,43,43,43,43,43,43,43,42,42,42,43
82,82,82,82,82,82,82,82,82,82,82,82,82,82,82,82,82,82,82,82,82,82,82,82,82,82,82,82,82,82,82,43,43,43,43,82,43,82,43,43,43,43,82,43,43,43,43,42,43,42
82,82,82,82,82,82,82,82,82,82,82,82,82,82,82,82,82,82,82,82,82,82,82,82,82,82,82,82,82,82,82,82,43,43,82,82,43,82,82,43,43,43,82,82,43,43,43,43,43,43
82,82,82,82,82,82,82,82,82,82,82,82,82,82,82,82,82,82,82,82,82,82,82,82,82,82,82,82,82,82,82,82,82,43,43,43,82,82,43,43,82,82,43,82,43,43,82,43,43,42
82,82,82,82,82,82,82,82,82,82,82,82,82,82,82,82,82,82,82,82,82,82,82,82,82,82,82,82,82,82,82,82,43,43,43,43,43,82,82,82,82,82,43,82,43,43,43,43,43,43
85,85,82,82,82,82,82,82,82,82,82,82,82,82,82,82,82,82,82,82,82,82,82,82,82,82,82,82,82,82,82,82,82,43,43,43,82,82,82,43,82,82,43,43,82,43,43,43,43,43
85,85,82,82,82,82,82,82,82,82,82,82,82,82,82,82,82,82,82,82,82,82,82,82,82,82,82,82,82,82,82,82,82,82,43,43,43,82,43,43,82,43,82,43,82,43,43,43,43,82
85,85,85,82,82,82,82,82,82,82,82,82,82,82,82,82,82,82,82,82,82,82,82,82,82,82,82,82,82,82,82,82,82,82,43,82,43,43,82,82,43,43,82,82,43,82,43,82,43,82
85,82,85,85,82,82,85,85,85,85,82,82,82,82,82,82,82,82,82,82,82,82,82,82,82,82,82,82,82,82,82,82,82,82,43,43,82,43,43,43,43,82,82,82,82,82,82,43,82,43
85,85,85,85,85,85,85,85,85,85,85,82,82,82,82,82,82,82,82,82,82,82,82,82,82,82,82,82,82,82,82,82,82,82,82,43,82,43,82,43,43,82,43,82,43,82,82,43,43,82
85,85,85,85,85,85,85,85,85,85,85,85,82,82,82,82,82,82,82,82,82,82,82,82,82,82,82,82,82,82,82,82,82,82,82,43,43,43,43,43,43,43,82,82,82,43,82,82,82,82
85,85,85,85,85,85,85,85,85,85,85,85,85,85,85,85,85,82,82,82,82,82,82,82,82,82,82,82,82,82,82,82,82,82,82,82,43,43,43,82,82,43,82,82,82,82,43,82,82,43
85,85,85,85,82,85,85,85,85,85,85,85,85,85,85,85,85,82,82,82,82,82,82,82,82,82,82,82,82,82,82,82,82,82,82,82,82,43,43,43,43,43,82,82,43,82,82,82,82,82
85,85,85,85,82,82,85,85,82,82,85,85,82,85,85,85,85,85,85,85,85,82,82,82,82,82,82,82,82,82,82,82,82,82,82,82,82,82,43,43,43,43,43,82,82,82,43,82,43,43
85,85,85,85,82,82,82,82,82,82,82,82,82,82,85,85,85,85,85,85,85,85,82,85,82,82,82,82,82,82,82,82,82,82,82,82,82,82,43,82,82,43,43,82,82,43,43,82,43,82
85,85,85,85,18,82,82,82,82,82,82,82,82,82,82,82,85,82,82,85,85,85,85,85,85,82,82,82,82,82,82,82,82,82,82,82,43,43,82,43,43,82,43,43,82,82,43,82,82,82
18,18,85,85,16,18,82,82,82,82,82,82,82,82,82,82,82,82,82,82,82,85,85,85,82,82,82,82,82,82,82,82,82,82,82,43,43,82,43,43,82,82,43,43,82,43,43,43,43,82
18,16,82,85,82,82,82,18,82,82,82,82,82,82,82,82,82,82,82,82,82,82,82,82,82,82,82,82,82,82,82,82,82,82,82,43,43,82,43,43,82,43,82,82,43,82,82,43,43,82
82,16,82,18,82,16,18,18,18,82,82,82,82,82,82,82,82,82,82,82,82,82,82,82,82,82,82,82,82,82,82,82,82,82,43,43,43,82,43,43,82,82,43,82,82,40,40,82,82,40
82,82,82,82,82,82,82,82,82,82,82,82,82,82,82,82,82,82,82,82,82,82,82,82,82,82,82,82,82,82,82,82,82,43,43,82,43,43,82,43,82,82,82,43,43,82,40,40,40,40
16,82,82,82,82,82,82,82,16,16,82,82,82,82,82,82,82,82,82,82,82,82,82,82,82,82,82,82,82,82,82,82,43,43,82,82,43,82,82,43,43,82,43,82,43,82,82,40,82,40
82,16,82,82,82,16,18,82,16,82,18,82,82,82,82,82,82,82,82,82,82,82,82,82,82,82,82,82,82,82,82,82,43,82,43,43,82,43,82,43,43,82,82,43,82,82,82,40,40,40
82,82,82,82,82,82,18,16,82,82,82,18,82,82,82,82,82,82,82,82,82,82,82,82,82,82,82,82,82,82,82,43,43,43,43,43,82,82,43,82,82,82,82,43,82,82,82,40,40,40
18,82,16,82,82,82,82,18,82,16,82,82,82,18,82,82,82,82,82,82,82,82,82,82,82,82,82,82,82,82,42,43,43,82,43,43,43,43,82,82,82,43,82,43,82,82,82,82,43,82
82,18,82,82,18,82,82,82,82,82,82,82,82,82,82,82,82,82,82,82,82,82,82,82,42,42,82,42,42,42,42,43,43,82,82,43,82,82,43,82,82,43,82,43,43,82,43,82,43,43
16,82,82,82,82,82,82,18,82,82,18,82,82,82,82,82,82,82,82,82,42,42,42,42,42,42,42,42,82,42,82,82,43,82,82,82,43,43,82,43,43,43,43,43,82,82,82,43,82,82
