20,20,17,22,85,85,20,85,20,20,20,20,20,20,17,20,20,20,17,20,20,20,17,22,20,20,20,20,16,22,19,79,82,82,82,82,82,82,82,82,82,82,82,82,82,82,82,82,82,82
20,20,20,20,20,85,20,85,85,20,20,20,20,20,20,20,20,20,20,20,22,20,20,20,22,17,20,17,16,16,20,19,79,82,82,82,82,82,82,82,82,82,82,82,82,82,82,82,82,82
85,20,20,20,20,85,85,20,85,20,20,20,20,20,20,20,20,20,20,22,20,20,17,20,20,20,22,19,20,20,20,16,19,82,82,82,82,82,82,82,82,82,82,82,82,40,40,82,82,82
85,20,85,20,20,20,85,85,85,20,20,20,20,20,20,20,20,20,20,20,20,20,20,22,20,20,20,20,20,50,19,20,19,16,79,82,82,82,82,82,82,82,82,82,82,40,40,40,82,82
85,20,85,85,85,85,85,20,20,20,20,20,20,20,20,20,20,20,20,22,20,20,20,20,20,17,20,20,20,20,50,16,20,16,79,82,82,82,82,82,82,82,82,82,82,82,40,40,40,82
85,85,85,17,20,85,85,85,20,20,20,20,20,20,20,20,20,20,20,22,20,17,20,20,20,20,20,20,20,20,20,50,16,19,19,79,82,82,82,82,82,82,82,82,82,82,82,40,40,40
20,85,85,20,20,17,85,85,20,20,20,20,20,20,20,20,20,20,20,20,22,20,20,20,20,17,17,22,20,20,20,20,20,20,20,20,20,82,82,82,82,82,82,82,82,82,82,40,40,40
20,20,85,20,20,17,20,85,85,20,20,20,20,20,20,17,20,20,35,38,38,38,38,38,38,27,38,38,38,38,38,38,38,38,38,38,38,82,82,82,82,82,82,82,82,82,82,82,40,40
20,20,85,85,20,22,20,20,85,85,20,20,20,20,22,20,20,33,20,20,17,20,20,20,20,39,17,22,20,20,50,20,19,20,22,20,22,16,82,82,82,82,82,82,82,82,82,82,82,82
20,20,85,85,85,85,17,20,85,85,85,85,85,20,20,20,20,39,20,20,17,17,20,22,20,39,20,20,20,20,20,20,20,19,19,20,20,16,16,16,82,82,82,82,82,82,82,82,82,82
85,85,85,17,20,85,85,20,85,85,85,85,85,20,20,20,20,39,22,20,20,20,20,20,20,20,20,20,20,20,17,20,20,20,20,19,50,20,19,16,16,16,16,82,82,82,82,82,82,82
85,85,85,20,17,20,22,85,85,17,20,85,85,20,20,20,20,39,20,20,20,20,20,20,20,20,20,20,20,20,20,20,20,20,50,20,50,50,50,19,19,82,82,82,82,82,82,82,82,82
85,85,20,20,17,20,17,85,85,22,17,20,85,85,85,20,20,39,20,17,17,20,20,20,20,39,20,22,17,22,20,20,22,20,20,50,50,20,19,19,19,16,16,82,82,82,82,82,82,82
85,20,20,22,20,20,20,20,85,85,20,20,85,85,85,20,20,39,20,20,22,20,20,20,20,39,20,20,17,20,20,20,20,20,20,20,50,20,20,20,19,19,19,82,82,82,82,82,82,82
20,20,20,17,22,17,20,20,20,85,85,20,85,85,85,85,20,39,20,20,20,20,22,20,20,39,20,20,20,20,20,20,20,20,20,20,20,50,20,20,20,50,19,19,82,82,82,82,82,82
22,17,20,17,17,17,17,20,20,20,85,85,85,85,20,20,20,39,20,20,22,20,20,20,20,39,22,20,20,20,17,20,20,17,20,20,20,20,50,20,22,22,20,19,19,79,82,82,82,82
20,20,20,17,20,17,22,20,20,20,85,85,85,85,20,20,20,39,20,20,20,20,20,20,20,39,20,20,20,20,22,17,20,22,20,20,20,20,20,50,20,20,20,17,17,79,50,82,82,82
20,20,20,20,20,17,22,20,20,22,20,85,85,85,20,20,20,39,20,20,20,20,20,20,20,39,20,20,20,20,20,20,20,20,20,20,20,20,20,20,50,20,20,20,50,50,50,50,50,50
20,20,20,20,20,22,22,20,20,20,20,20,85,85,85,20,20,39,20,20,20,20,20,20,17,39,20,20,20,20,20,20,20,20,17,17,20,20,20,20,20,20,20,20,50,50,20,20,20,50
20,20,20,20,20,20,22,20,20,20,20,20,20,20,20,20,20,39,20,20,20,20,20,20,20,39,20,20,20,20,20,20,17,20,20,22,20,20,22,20,20,20,20,20,50,20,50,20,20,20
38,38,38,38,38,38,38,38,38,38,31,20,20,20,22,20,20,39,20,20,20,20,20,20,22,39,20,20,20,20,20,20,20,20,17,20,20,20,20,20,20,20,50,50,20,20,20,50,20,20
38,38,38,38,38,38,38,38,38,31,39,20,20,22,20,20,20,39,20,20,20,20,20,20,20,39,20,20,20,22,20,20,20,17,20,20,17,20,20,50,20,20,50,50,50,20,22,22,50,20
20,20,22,20,17,20,20,20,22,39,39,20,20,20,22,17,22,24,38,38,38,38,38,38,38,32,22,22,20,17,20,20,20,20,17,20,20,20,20,50,20,20,50,50,50,50,20,20,20,20
20,20,17,20,20,20,20,20,22,39,39,22,20,20,22,20,20,39,20,20,20,20,20,20,20,22,20,20,20,20,22,20,20,20,17,20,20,20,20,20,20,20,20,20,50,50,20,20,17,50
22,20,20,20,20,17,20,22,20,39,39,17,20,20,20,20,20,39,20,20,20,20,20,20,20,20,17,17,20,20,20,20,17,20,20,20,17,20,20,20,20,20,20,20,20,50,20,20,20,22
22,20,17,20,20,22,20,17,22,39,39,20,20,20,20,22,20,39,20,20,20,20,20,20,20,20,22,20,20,20,20,17,20,17,20,20,20,20,17,20,20,50,20,20,50,20,50,20,20,20
20,20,17,20,20,20,20,22,17,39,39,20,20,17,20,20,20,39,20,20,20,20,20,20,20,20,22,20,20,20,20,20,17,20,20,20,20,22,20,20,20,20,20,20,50,50,50,50,17,22
44,20,20,20,20,20,22,20,22,39,39,20,20,20,20,20,20,39,20,20,20,20,20,20,20,20,20,20,20,17,20,17,17,20,20,20,20,20,17,20,20,20,20,20,50,20,20,22,17,20
44,44,44,20,20,20,20,20,17,39,39,20,20,20,20,20,20,39,20,20,20,20,20,20,20,20,20,20,20,17,20,20,20,20,17,20,20,17,20,20,20,20,20,20,50,20,20,50,17,22
44,44,44,44,44,44,20,20,35,26,26,38,38,38,38,38,38,32,20,17,20,20,20,20,20,20,20,20,20,17,20,17,20,20,20,20,20,20,20,20,20,20,20,20,20,20,20,17,50,22
44,44,44,44,44,44,44,44,20,20,20,20,20,20,20,20,20,20,17,17,20,20,20,20,20,20,20,20,20,20,20,20,17,20,20,20,20,22,20,20,20,20,20,20,20,20,20,22,22,20
44,44,44,44,44,44,44,44,44,44,20,20,20,20,20,20,17,17,17,20,20,20,20,20,20,20,17,20,20,17,20,20,20,20,20,20,20,20,22,20,20,20,20,17,20,20,22,20,20,20
44,44,44,44,44,44,44,44,44,44,44,20,20,20,20,20,17,20,20,22,17,20,17,20,20,20,20,20,20,20,17,17,20,20,17,20,20,20,22,20,20,20,20,20,20,20,20,17,22,22
44,44,44,44,44,44,44,44,44,44,44,44,20,20,20,17,17,17,20,20,17,17,17,20,20,20,20,20,20,17,17,17,20,20,20,20,20,20,20,20,20,20,20,20,20,20,22,17,20,17
85,85,44,44,44,44,44,44,44,44,44,44,44,20,20,20,17,17,17,20,20,17,17,17,17,20,20,20,20,20,20,20,20,20,20,20,20,20,20,20,20,20,17,20,20,20,22,22,17,20
44,44,85,44,44,44,44,44,44,44,44,44,44,44,20,20,20,20,20,17,17,20,20,17,20,17,17,17,20,20,20,20,20,20,20,20,17,20,20,20,20,20,20,20,20,20,17,20,20,17
44,44,44,85,85,85,44,44,44,44,20,44,44,44,44,20,20,20,20,20,17,17,20,20,20,20,20,20,17,20,20,20,20,20,20,20,20,17,20,22,20,20,22,20,20,22,22,20,20,20
85,85,85,85,20,85,85,44,44,44,17,20,20,44,44,44,44,44,20,20,17,17,20,20,20,17,17,17,20,20,20,17,20,20,20,20,22,22,20,20,20,20,20,20,20,22,20,17,17,17
85,85,85,85,85,85,85,85,44,44,44,44,17,17,44,44,44,44,44,44,17,17,17,20,17,17,20,17,17,20,17,20,17,20,20,20,20,20,22,20,20,20,20,20,20,20,20,17,20,20
44,85,85,85,85,85,85,20,85,85,44,44,44,20,44,44,44,44,44,44,44,44,20,17,20,17,17,20,20,20,17,20,20,17,20,20,20,20,22,20,20,20,20,20,17,20,20,20,17,20
85,44,85,85,85,85,85,85,85,85,85,44,44,44,44,44,20,44,44,44,44,44,44,44,17,20,20,17,20,20,20,20,20,20,20,20,20,20,20,20,17,20,17,20,22,20,20,20,20,22
85,85,85,85,85,85,85,85,20,85,85,44,44,44,44,44,44,20,44,20,44,44,20,44,44,17,20,20,20,17,20,20,20,20,20,20,20,20,20,20,20,20,20,20,20,20,20,22,20,20
85,44,85,85,85,85,85,85,85,85,85,85,44,44,44,44,17,44,44,44,20,44,44,44,44,44,17,17,20,20,17,20,20,20,22,20,20,20,20,17,20,20,22,20,20,22,20,22,17,20
85,85,85,85,85,85,85,85,85,85,85,85,85,85,44,44,44,17,20,17,44,20,20,44,44,44,44,17,20,17,20,20,17,20,22,17,20,20,20,20,20,20,20,20,20,20,20,20,20,17
85,85,85,85,85,85,85,85,85,85,85,85,85,85,85,44,44,44,20,20,44,44,20,44,44,44,44,20,20,20,17,20,20,20,22,22,20,20,17,20,20,20,20,20,20,20,20,20,20,20
85,85,85,85,85,85,85,85,44,85,85,85,17,85,85,85,44,44,44,44,44,44,44,44,44,44,44,44,20,20,17,20,20,17,17,20,20,20,20,22,20,20,20,20,20,20,20,20,20,17
85,85,85,85,85,44,85,85,85,44,85,85,85,85,85,85,85,44,44,44,44,44,44,44,44,44,44,44,44,20,22,20,20,20,22,22,20,20,20,20,20,20,20,20,20,20,20,20,20,17
85,85,85,85,85,85,44,85,85,85,85,85,85,85,85,85,85,85,85,44,44,44,20,20,17,44,44,44,44,20,20,20,22,17,20,20,20,20,20,20,20,20,20,20,20,20,20,20,20,20
85,85,85,85,85,85,85,44,85,85,85,85,85,85,85,20,85,85,85,85,44,44,44,44,44,20,20,44,44,20,20,20,20,17,20,22,20,20,22,17,20,20,20,20,20,20,20,20,20,20
85,85,85,85,85,85,85,85,85,85,85,85,20,85,85,85,20,17,85,85,85,85,44,44,44,17,17,20,44,44,20,20,22,20,20,20,20,20,20,20,20,20,20,20,20,20,20,20,20,20
